puolisotilaalliseen	puoli/sotilaa/llise/en
kansalaisjärjestötapaamisen	kansalais/järjestö/tapaa/mise/n
pienimäelle	pieni/mäe/lle
herkistyykin	herkist/y/y/kin
myrkkysäiliöitä	myrkky/säiliö/i/tä
velkojaksi	velko/ja/ksi
istumapaikkaansa	istu/ma/paikka/a/nsa
vialliseen	via/llise/en
ylähirrestä	ylä/hirre/stä
päinvastaiseksi	pä/i/n/vastaise/ksi
sekaannutaan	sekaannu/ta/an
luvattaisiin	luva/tta/isi/in
kansainliitossa	kansa/i/n/liito/ssa
mutaisella	mutaise/lla
liiterille	liiteri/lle
muistonsa	muisto/nsa
kerrostalokorttelin	kerros/talo/kortteli/n
miesmäiseksi	mies/mäise/ksi
tihkusadetta	tihku/sadet/ta
kertomalla	kerto/ma/lla
juniorityössä	juniori/työ/ssä
lasitie	lasi/tie
elvis	elvis
päivätansseja	päivä/tansse/j/a
ennennäkemättömäksi	ennen/näkemättömä/ksi
ilmarevolveri	ilma/revolveri
selviytymistaistelu	selviyty/mis/taistel/u
lamakausina	lama/kaus/i/na
henkäyksen	henkäykse/n
vehkeitä	vehke/i/tä
huolellisuudella	huole/llis/uude/lla
viimeistelyssä	viimeistel/y/ssä
työturvalla	työ/turva/lla
poijut	poiju/t
motivoivaksi	motivoi/va/ksi
erikoisjoukot	erikois/jouko/t
kuluttajahintaindeksistä	kulu/tta/ja/hinta/indeks/is/tä
islantilaisesta	islanti/laise/sta
hampaissaan	hampa/i/ssa/an
siirto-operaation	siirto/-/operaatio/n
demarilähteiden	demari/lähte/i/den
sähkösaunan	sähkö/sauna/n
peruuttikin	peruutt/i/kin
psykoterapeutista	psyko/terapeuti/sta
pöytäniemi	pöytä/niemi
puske	puske
sojoteltavasta	sojot/el/ta/va/sta
höystää	höystä/ä
selkiytymätön	selkiyt/y/mätön
väliinputoajaryhmä	väli/in/putoa/ja/ryhmä
viimeisteltäväksi	viimeistel/tä/vä/ksi
sädehoidot	säde/hoido/t
verrattiin	verra/tt/i/in
perusteltu	perust/el/tu
koulukysymykset	koulu/kysymykse/t
suusyövistä	suu/syö/v/i/stä
pestipalvelusta	pesti/palvel/u/sta
humussa	humu/ssa
sokeripitoisuuteen	sokeri/pitois/uute/en
bryssel	bryssel
yleisurheilujoukkueen	yleis/urheil/u/joukkuee/n
kuullulla	kuul/lu/lla
jokeripelaaja	jokeri/pelaa/ja
sotarikoksista	sota/rikoks/i/sta
natsoista	natso/i/sta
totuuksien	totuuks/i/en
menetelmänä	menetelmä/nä
saaliisiin	saali/i/siin
yhteysjohtajaksi	yhteys/johta/ja/ksi
alkusyksyisin	alku/syksyis/i/n
näreneva	näre/neva
alkuvoimaisten	alku/voi/mais/t/en
terästäytyä	terästäyty/ä
verrokkeja	verrokke/j/a
terroristiryhmä	terroristi/ryhmä
erillisinäkin	erillis/i/nä/kin
kapteenina	kapteeni/na
miinoitetut	miinoite/tu/t
kovettaa	kovetta/a
flamencoperinteen	flamenco/perintee/n
tekijöineen	tekijö/ine/en
opinto-ohjelman	opinto/-/ohjelma/n
salamityyppiset	salami/tyyppise/t
tekaistuun	tekais/tu/un
laukkaamaan	laukkaa/ma/an
avuntarjouksen	avu/n/tarjoukse/n
epäuskottavan	epäusko/tta/va/n
ihmeissämme	ihme/i/ssä/mme
vertailuarvoon	verta/il/u/arvo/on
kunnianarvoisalle	kunnia/n/arvoisa/lle
luettavaksi	lue/tta/va/ksi
ennakkovoitelua	ennakko/voitel/u/a
joosefin	joosefi/n
tienaavaa	tienaa/va/a
letkautus	letkaut/us
presidenteille	presidente/i/lle
istuin	istu/i/n
kana	kana
pianojen	piano/j/en
dortmundissa	dortmundi/ssa
sotilaskarkuruuden	sotilas/karkuruude/n
koulutettavien	koulute/tta/v/i/en
rauhasten	rauhas/t/en
asuntokortteleita	asunto/korttele/i/ta
pietarilaisryhmän	pietarilais/ryhmä/n
laivaväylät	laiva/väylä/t
valmistusvaiheissa	valmist/us/vaihe/i/ssa
ylpeydenaiheemme	ylpe/yde/n/aihee/mme
hanskojen	hansko/j/en
kioskiryöstäjiä	kioski/ryöstä/j/i/ä
seksualiteetin	seksualiteeti/n
asuttamamme	asu/tta/ma/mme
ympäristövalmiusjoukon	ympäristö/valmius/jouko/n
tampere-kuopio	tampere/-/kuopio
kaikenkokoisissa	kaike/n/kokois/i/ssa
minuuttiaikataulua	minuutti/aika/taulu/a
liikuntajohtajaksi	liiku/nta/johta/ja/ksi
junavaunu	juna/vaunu
osavaltioidensa	osa/valtio/i/de/nsa
viikkolaskuri	viikko/laskuri
tavaroihinsa	tavaro/i/hi/nsa
aurausta	aura/us/ta
jääkiekkoileva	jää/kiekkoile/va
lastenhuollosta	las/t/en/huollo/sta
daniel	daniel
vastustanutta	vastusta/nut/ta
lastenteatteri	las/t/en/teatteri
etutassujen	etu/tassu/j/en
veteraanisarja	veteraani/sarja
piristysruisku	pirist/ys/ruisku
kolmikkona	kolmikko/na
lomarakennusta	loma/rakenn/us/ta
valtapoliittinen	valta/poliittinen
päärautatieasema	pää/rauta/tie/asema
ohjailemista	ohja/ile/m/i/sta
kuusituntinen	kuusi/tuntinen
koroin	koro/i/n
kuoppasi	kuoppa/si
muunrotuisia	muu/n/rotuis/i/a
laatijaksi	laati/ja/ksi
osakkeenomistajiaan	osakkee/n/omista/j/i/a/an
mielenterveyspalveluja	miele/n/terve/ys/palvel/u/j/a
rypäälle	rypää/lle
opintovelkoja	opinto/velko/j/a
leveähartiainen	leveä/hartiainen
läänikohtaiset	lääni/kohtaise/t
lokomosta	lokomo/sta
ylhäältäpäin	ylhää/ltä/päin
pilvenmäki	pilve/n/mäki
rantakurvi	ranta/kurvi
hokemia	hoke/m/i/a
jäsenkuntaan	jäsen/kunta/an
rakennusluvan	rakenn/us/luva/n
hirsiperinnekoulun	hirsi/perinne/koulu/n
asettajista	asetta/j/i/sta
energiantuottajana	energia/n/tuotta/ja/na
ydinvaltojen	ydin/valto/j/en
kassamagneettien	kassa/magneett/i/en
kuvana	kuva/na
tupaantuliaispaikalle	tupa/an/tuliais/paika/lle
rangaistustulli	rangaistus/tulli
piirrosfilmissä	piirros/filmi/ssä
uutislähteenä	uutis/lähtee/nä
jousituksesta	jousit/ukse/sta
oksentavia	oksenta/v/i/a
pirstoutuneiden	pirsto/utu/ne/i/den
stipendeistä	stipende/i/stä
kinttupoluksi	kinttu/polu/ksi
sysmää	sysmä/ä
epäsuotuiset	epäsuotuise/t
arvovaltansakin	arvo/valta/nsa/kin
bratislavan-suurlähettiläs	bratislava/n/-/suur/lähettiläs
sumea	sumea
takaisinmaksuaikaa	takais/i/n/maksu/aika/a
shanghaissa	shangha/i/ssa
asuntoluototuksessa	asunto/luotot/ukse/ssa
suomalaisristeilijöitä	suomalais/riste/ili/jö/i/tä
päällekkäisiltä	päällekkäis/i/ltä
kaksinaisen	kaksinaise/n
tomaattisosetta	tomaatti/soset/ta
ykkösohjelmarahaa	ykkös/ohjelma/raha/a
yrjölällä	yrjölä/llä
urissa	ur/i/ssa
kinkkusuikaleita	kinkku/suikale/i/ta
hallintoihmisiä	hallinto/ihmis/i/ä
yhteistutkimusta	yhteis/tutkimus/ta
manttelinperijöitä	mantteli/n/peri/jö/i/tä
kokkareinen	kokkareinen
pahat	paha/t
etutukivarsi	etu/tuki/varsi
suojautumistoimiin	suojautu/mis/toim/i/in
jäsentämässä	jäsentä/mä/ssä
vastaanottaessani	vastaanotta/e/ssa/ni
neuvontapalveluihin	neuvonta/palvel/u/i/hin
näköispainokset	näköis/painokse/t
metsäkauriin	metsä/kauri/i/n
viestiviä	viesti/v/i/ä
lukuiloa	luku/ilo/a
sipoossa	sipoo/ssa
kompastumisestaan	kompastu/mise/sta/an
neuroradiologian	neuro/radiologia/n
hankintaansa	hanki/nta/a/nsa
puheenjohtajakokoukselle	puhee/n/johta/ja/kokoukse/lle
rintamasotilastunnusta	rintama/sotilas/tunnu/sta
häiriintyneessä	häiriinty/nee/ssä
iltalehdessä	ilta/lehde/ssä
plussasta	plussa/sta
palvelusetelikokeilun	palvel/u/seteli/kokeil/u/n
musiikissaan	musiiki/ssa/an
kansanosia	kansa/n/os/i/a
vähimmäistasoja	vähimmäis/taso/j/a
tulkitsemme	tulkitse/mme
peruslaitteistot	perus/laitteisto/t
puhdaspiirteisimpiä	puhdas/piirteis/imp/i/ä
ainuttakaan	ainut/ta/kaan
kuuntelisi	kuuntel/isi
ylityömääräystä	ylityö/määrä/ys/tä
rehumyynti	rehu/myy/nti
tasoittuessa	tasoitt/u/e/ssa
pukeutuu	puke/utu/u
amatööriseura	amatööri/seura
verovapaina	vero/vapa/i/na
erityishuippukokouksesta	erityis/huippu/kokoukse/sta
naureskelija	naureskeli/ja
avustajakoiran	avusta/ja/koira/n
kroaattijohtajaa	kroaatti/johta/ja/a
kymmenien	kymmen/i/en
säestämistä	säestä/m/i/stä
päätyyppiin	pää/tyyppi/in
veronmaksajille	vero/n/maksa/j/i/lle
tietoväylä	tieto/väylä
tilinpäätöstietojen	tili/n/päätös/tieto/j/en
ratsastusaika	ratsast/us/aika
verohelpotuksillaan	vero/helpot/uks/i/lla/an
konnatroikkaa	konna/troikka/a
vaikeuttamisella	vaikeutta/mise/lla
eno	eno
kalkinpoistoaineen	kalki/n/poisto/ainee/n
talitintin	tali/tinti/n
nummijärvelle	nummi/järve/lle
samanasteinen	sama/n/asteinen
uuhien	uuh/i/en
erkaantuivat	erkaantu/i/vat
triljoonalla	triljoona/lla
purrella	purre/lla
jokavuotisia	jo/ka/vuotis/i/a
akrobaattiset	akrobaatt/ise/t
väestönlaskennan	väestö/n/laske/nna/n
hallinnonhaarat	hallinno/n/haara/t
liigavoiton	liiga/voi/ton
oppositioedustaja	oppositio/edusta/ja
kotiradan	koti/rada/n
ohjelmatuotannolle	ohjelma/tuotanno/lle
luomisvoiman	luo/mis/voima/n
telakkayhtiölle	telakka/yhtiö/lle
nauhakaupungin	nauha/kaupungi/n
teollistuneet	teollist/u/nee/t
joulunvihreä	joulu/n/vihreä
kalahtelevin	kalaht/ele/v/i/n
vaellan	vaella/n
kiimassa	kiima/ssa
tautiperintö	tauti/perintö
merkkituotteiden	merkki/tuotte/i/den
ratkaisuperiaate	ratkais/u/peri/aate
seuransa	seura/nsa
tärvelemästä	tärvele/mä/stä
tuoduksi	tuo/du/ksi
korjausavustukset	korja/us/avust/ukse/t
pisteitäni	piste/i/tä/ni
järjestöelämään	järjestö/elämä/än
dealer	dealer
ihannevastustajat	ihanne/vastusta/ja/t
panttivankiasian	pantti/vanki/asia/n
hankkimia	hankki/m/i/a
steiner-koulun	steiner/-/koulu/n
elämänkäsitykseen	elä/mä/n/käsitykse/en
halpamyyntiä	halpa/myy/nti/ä
ei-kielellisiä	ei/-/kiele/llis/i/ä
lapsuusmuistot	lapsuus/muisto/t
rajaviranomainen	raja/vira/n/omainen
kylmenevässä	kylmene/vä/ssä
kaivostoiminnalla	kaivos/toimi/nna/lla
kuluttajaliitosta	kulu/tta/ja/liito/sta
onnittelijaa	onnitteli/ja/a
hingusta	hingu/sta
viljatuotteet	vilja/tuottee/t
meluhaitta	melu/ha/i/tta
oppimistani	oppi/m/i/sta/ni
valintamahdollisuuksiin	vali/nta/mahdollis/uuks/i/in
jälkijättöiseltä	jälki/jättöise/ltä
viljelytiloja	viljel/y/tilo/j/a
myyntiehdoista	myy/nti/ehdo/i/sta
salamointia	salamoi/nti/a
palkankorotusvaatimusta	palka/n/korot/us/vaatimus/ta
vaihtopisteitä	vaihto/piste/i/tä
tikkarin	tikkari/n
ajosuuntaa	ajo/suunta/a
kauhuromantiikka	kauhu/romantiikka
manchesterissa	manchesteri/ssa
yhdeksättä	yhdeksä/t/tä
linja-autoksi	linja/-/auto/ksi
tulvavesistä	tulva/ves/i/stä
mielipidekyselyyn	mieli/pide/kysel/y/yn
perhetuet	perhe/tue/t
mirjamia	mirjami/a
erotumme	erot/u/mme
järkeenkäyvältä	järke/en/käyvä/ltä
ahdistetun	ahdiste/tu/n
kaakkoisrajan	kaakkois/raja/n
halpenemisena	halpene/mise/na
hajamielisyyteen	haja/mielis/yyte/en
polvipituus	polvi/pituus
kansalliseläimen	kansallis/eläime/n
kitkettävä	kitke/ttä/vä
odotuksille	odot/uks/i/lle
kara	kara
kalaniemen	kala/nieme/n
purkakaa	purka/kaa
vahingoittamien	vahingoitta/m/i/en
saumaa	sauma/a
kulkeeko	kulke/e/ko
kouristuvat	kourist/u/va/t
filosofoiva	filosofoi/va
pitämistä	pitä/m/i/stä
tiedetoimittajat	tiede/toimi/tta/ja/t
tavarahuolto	tavara/huolto
luokkakokouksemme	luokka/kokoukse/mme
oskulla	osku/lla
huojuivat	huoju/i/vat
vuorokone	vuoro/kone
ajoilta	ajo/i/lta
virheeni	virhee/ni
turvallisuusjoukkonsa	turva/llis/uus/joukko/nsa
katsotuissa	katso/tu/i/ssa
piirustelun	piirust/el/u/n
jalkapallovuosi	jalka/pallo/vuo/si
erikoisnuuskan	erikois/nuuska/n
eräkämppä	erä/kämppä
hypoteettisia	hypoteettis/i/a
koulupohjalla	koulu/pohja/lla
voitelu	voitel/u
vaalikierroksella	vaali/kierrokse/lla
halventaisi	halve/nta/isi
tehdyiksi	teh/dy/i/ksi
hömpöttelee	hömpött/ele/e
tarjoavaa	tarjoa/va/a
merenkulkuelinkeinon	mere/n/kulku/elin/keino/n
rangaistuspysähdykseen	rangaistus/pysähdykse/en
pienosakkaille	pie/n/osakka/i/lle
velkajärjestelyllä	velka/järjest/el/y/llä
optikkoliikkeeseen	optikko/liikkee/seen
laiturinnokassa	laituri/n/noka/ssa
pidättämisessä	pidättä/mise/ssä
äänestäneeni	äänestä/nee/ni
kilimanjaro-maastopyörä	kilimanjaro/-/maasto/pyörä
pelastusliittojen	pelast/us/liitto/j/en
puuhiinsa	puuh/i/i/nsa
jumalanpilkan	jumala/n/pilka/n
hetkellinen	hetke/llinen
karhunpalvelus	karhu/n/palvelus
suomestahan	suome/sta/han
eleensä	elee/nsä
kuljetusmäärät	kuljet/us/määrä/t
nettiin	netti/in
sotilasjoukon	sotilas/jouko/n
toimitustyöhön	toimi/t/us/työ/hön
syömiskäyttäytyminen	syö/mis/käyttä/yty/minen
purkitettuja	purkite/ttu/j/a
maastamuuttajan	maa/sta/muuttaja/n
piikkiöläisen	piikkiö/läise/n
talouspaperit	talous/paperi/t
latuihin	latu/i/hin
torjuntapolitiikka	torjunta/politiikka
reumaa	reuma/a
mataluutta	matal/uut/ta
tunnelia	tunneli/a
tähtikultti	tähti/kultti
estepuolellakin	este/puole/lla/kin
mielipidevangin	mieli/pide/vangi/n
lakkaamattomat	lakkaa/mattoma/t
alalajia	ala/laji/a
valmistaudumme	valmistaudu/mme
patamustimmatkin	pata/must/imma/t/kin
torstaisin	torstais/i/n
myymälöitään	myymälö/i/tä/än
pidettykään	pide/tty/kään
terrorismi-sanan	terrorismi/-/sana/n
mediatapahtuma	media/tapahtuma
työssäkin	työ/ssä/kin
luonnonominaisuuksien	luonno/n/ominais/uuks/i/en
ryppyiseksi	ryppyise/ksi
uudenaikaistaa	uudenaikaista/a
muovilaidat	muovi/laida/t
sähköhellasta	sähkö/hella/sta
tulojaan	tulo/j/a/an
könttäsummalla	könttä/summa/lla
eurokuluttajina	euro/kulu/tta/j/i/na
erikoispalveluissa	erikois/palvel/u/i/ssa
kansainvälisenkin	kansa/i/n/väli/senki/n
kööriä	kööri/ä
konsulttityöt	konsultti/työ/t
päivitettyjä	päivite/tty/j/ä
juomateollisuuteen	juo/ma/teollis/uute/en
komppaniamme	komppania/mme
foorumille	foorumi/lle
ambulanssia	ambulanssi/a
kestosuosikit	kesto/suosiki/t
herraseuraa	herra/seura/a
adoptiotyttärensä	adoptio/tyttäre/nsä
kemiaan	kemia/an
objektiiveista	objektiive/i/sta
toteutusaika	toteut/us/aika
käytännöllisyyttä	käytännö/llis/yyt/tä
kovempaan	kove/mpa/an
uhkasta	uhka/sta
opiskelutapojen	opiskel/u/tapo/j/en
otetaankin	ote/ta/an/kin
kansa-yhtymän	kansa/-/yhtymä/n
musiikkilehdistö	musiikki/lehdistö
eurooppa-sopimuksissa	eurooppa/-/sopimuks/i/ssa
päiväetappeja	päivä/etappe/j/a
matkailijayhdistyksen	matka/ili/ja/yhdist/ykse/n
irrotettavaa	irrote/tta/va/a
osastonaan	osasto/na/an
sopeutuvuudesta	sopeut/u/v/uude/sta
kielelliselle	kiele/llise/lle
kysyisivät	kysy/isi/vät
retkeilyvarusteita	retkeil/y/varuste/i/ta
kuriositeettia	kuriositeetti/a
rämältä	rämä/ltä
iskunvaimentimia	isku/n/vaimentim/i/a
palkatut	palka/tu/t
kieppeille	kieppei/lle
käyttövaatteiden	käyttö/vaatte/i/den
sillanpää	silla/n/pää
kiilautuneet	kiilautu/nee/t
romaaniensa	romaan/i/e/nsa
varmuudesta	varm/uude/sta
pressin	pressi/n
henkilöhaastatteluilla	henkilö/haasta/tt/el/u/i/lla
vaimoaan	vaimo/a/an
kosketat	kosketa/t
lähentymisehdoista	lähenty/mis/ehdo/i/sta
varastohallin	varasto/halli/n
arkityylissä	arki/tyyli/ssä
turvapaikanhakuun	turva/paika/n/haku/un
miinusmerkkisistä	miinus/merkkis/i/stä
kuivasaarta	kuiva/saar/ta
haasteltu	haast/el/tu
asukaskokouksessa	asukas/kokoukse/ssa
venetelineiden	vene/teline/i/den
tuontikiintiöistä	tuonti/kiintiö/i/stä
tarjoaisi	tarjoa/isi
neuvostoa	neuvosto/a
pentiumeihin	pentiume/i/hin
säästöistään	säästö/i/stä/än
tanska-norjan	tanska/-/norja/n
parhaimmasta	parha/imma/sta
elementtityö	elementti/työ
puolimaista	puoli/ma/i/sta
kaavoineen	kaavo/ine/en
siirtolaispolitiikkaan	siirtolais/politiikka/an
virtausmittari	virta/us/mittari
kuollutkin	kuol/lu/t/kin
sanoudun	sanoudu/n
tunkeuduimme	tunke/udu/i/mme
vetäjäpula	vetä/jä/pula
raportoiden	raportoi/de/n
metsäseudulla	metsä/seudu/lla
pudotukseksi	pudot/ukse/ksi
sisustuksenkin	sisust/ukse/n/kin
millimetrintarkasti	milli/metri/n/tarka/sti
arabiemiirikunnissa	arabi/emiiri/kunn/i/ssa
ratian	ratia/n
ruoppauksen	ruoppa/ukse/n
raivostuttavalta	raivostu/tta/va/lta
kaksinapaisuus	kaksi/napais/uus
teatterisalin	teatteri/sali/n
laskijoiden	laski/jo/i/den
aurinkotyttö-kisa	aurinko/tyttö/-/kisa
ongelmaluotot	ongelma/luoto/t
paroselle	parose/lle
avausraita	ava/us/raita
taistelukranaattia	taistel/u/kranaatti/a
heteroseksuaalit	heteroseksuaali/t
viherrakentajien	viher/rakenta/j/i/en
ropinaa	ropi/na/a
komistua	komist/u/a
järjestäjäseurat	järjestä/jä/seura/t
rotko	rotko
heikkoselta	heikkose/lta
viljanmaalla	vilja/n/maa/lla
levälajistoon	levä/lajisto/on
videopalvelimelta	video/palvelime/lta
kyproksessa	kyprokse/ssa
vinoutumista	vinout/u/m/i/sta
poliisioikeuden	poliisi/oike/ude/n
kasvuennusteet	kasvu/ennustee/t
talousuutisissa	talous/uutis/i/ssa
voittoa	voitto/a
viitehinta	viite/hinta
euroseteleiden	euro/setele/i/den
ekblomin	ekblomi/n
munapäät	muna/pää/t
avantgardistit	avantgardisti/t
vuoriseen	vuorise/en
aatteilla	aatte/i/lla
ideologisia	ideologis/i/a
moraalimme	moraali/mme
maalaako	maalaa/ko
ilmoitusmarkkoja	ilmoit/us/markko/j/a
keskiaikaiseksi	keski/aikaise/ksi
suolattuna	suola/ttu/na
edustajanaan	edu/sta/jana/an
sinetti	sinetti
rahasotkut	raha/sotku/t
intohimoisena	into/himoise/na
terapeuttinenkin	terapeuttinen/kin
olympiajoukkueen	olympia/joukkuee/n
suoloiksi	suolo/i/ksi
koulukkaan	koulukkaa/n
kohtamaan	kohta/maa/n
heikkouksistaan	heikko/uks/i/sta/an
luonnosmainen	luonnos/mainen
autokauppiaalle	auto/kauppiaa/lle
pukeutua	puke/utu/a
kanssakilpailijoiden	kanssa/kilpaili/jo/i/den
infektiovahinkoja	infektio/vahinko/j/a
vähistä	väh/i/stä
lihallisesta	liha/llise/sta
tenttiajat	tentti/aja/t
verillä	ver/i/llä
normaalivartaloisia	normaali/vartalois/i/a
aluehälytyskeskukselle	alue/hälyt/ys/keskukse/lle
vilkaiskaapa	vilkais/kaa/pa
polyfonista	polyfonis/ta
pääsykoerumba	pääsy/koe/rumba
investointiosuudesta	investoi/nti/osuude/sta
finanssikeskus	finanssi/keskus
vapaaehtoistyöntekijät	vapa/a/ehtois/työ/n/tekijä/t
panttioikeuteen	pantti/oike/ute/en
sukkahousuniksejä	sukka/housu/nikse/j/ä
myöhemmässä	myöhe/mmä/ssä
porotalousneuvoja	poro/talous/neuvo/ja
kulttuuritajunnassa	kulttuuri/tajunna/ssa
päivystysvalmiutta	päivyst/ys/valmiut/ta
uratie	ura/tie
langetettujen	langete/ttu/j/en
filosofioista	filosofio/i/sta
nettomenoiltaan	netto/meno/i/lta/an
roolieni	rool/i/e/ni
soijatuotteiden	soi/ja/tuotte/i/den
elokuvarahasto	elo/kuva/rahasto
artosta	arto/sta
riippunee	riippu/ne/e
vienti	vie/nti
puurunkoisiksi	puu/runkois/i/ksi
kohdissaan	kohd/i/ssa/an
kokeisiin	koke/i/siin
luottotappioille	luotto/tappio/i/lle
velvollisuus	velvollis/uus
joukkuemäessäkin	joukkue/mäe/ssä/kin
pyöritetään	pyöri/te/tä/än
tiedonsaantioikeuden	tiedo/n/saa/nti/oike/ude/n
vähimmäissuojan	vähimmäis/suo/ja/n
palkansaajilla	palka/n/saa/j/i/lla
pääpuoleksi	pää/puole/ksi
tuonnin	tuonni/n
elämöineet	elämöi/nee/t
arvoasetelman	arvo/asetelma/n
lääkärihelikopterien	lääkäri/helikopter/i/en
kristiinankaupungista	kristiinankaupungi/sta
euroveteraani	euro/veteraani
jättipalikoista	jätti/paliko/i/sta
sidottuina	sido/ttu/i/na
haurastumiseen	haurastu/mise/en
keskushenkilöt	keskus/henkilö/t
punamultamaalia	puna/multa/maali/a
julkisuushyödyn	julkis/uus/hyödy/n
savilahdentie	savi/lahde/n/tie
hakuominaisuuksia	haku/ominais/uuks/i/a
yksilöille	yksilö/i/lle
sijoittajasta	sijoitta/ja/sta
kesäjuhlista	kesä/juhl/i/sta
psykosomaattisen	psyko/somaattise/n
pengerkatu	penger/katu
eilat	eila/t
teoista	teo/i/sta
hennoissa	henno/i/ssa
huippukokouksia	huippu/kokouks/i/a
höyrykattila	höyry/kattila
raportoinnilla	raportoi/nni/lla
kokkolasta	kokko/las/ta
hellepäivä	helle/päivä
kärkiheittäjien	kärki/heittä/j/i/en
kahdeksaansataan	kahdeksa/an/sata/an
piere	piere
soolotrumpetisti	soolo/trumpetisti
ravintolisistä	ravinto/lis/i/stä
venäläislähteet	venäläis/lähtee/t
rumemmaksi	rume/mma/ksi
sivuseinät	sivu/seinä/t
sankarimytologiaa	sankari/mytologia/a
vaihtoehdossakin	vaihto/ehdo/ssa/kin
muodostavasta	muodosta/va/sta
sähköautoon	sähkö/auto/on
naamiota	naamio/ta
eu-edustus	eu/-/edust/us
oireiksi	oire/i/ksi
yleispätevän	yleis/päte/vä/n
television	tele/visio/n
päätynee	pääty/ne/e
arvosanojensa	arvo/sano/j/e/nsa
hosumista	hosu/m/i/sta
terveyspalveluja	terve/ys/palvel/u/j/a
kilpailutetaan	kilpail/ute/ta/an
elvyttävistä	elvy/ttä/v/i/stä
raskauttavista	raskautta/v/i/sta
perheenemännällä	perhee/n/emännä/llä
tilastollisesti	tilasto/llise/sti
karhunen	karhunen
kehittäjiin	kehittä/j/i/in
sinilippu	sini/lippu
eduskuntaryhmän	edus/kunta/ryhmä/n
kotivaltiossaan	koti/valtio/ssa/an
nähdessä	näh/de/ssä
kirkkoherranvaali	kirkko/herra/n/vaali
uhista	uh/i/sta
sikanen	sikanen
karahtaminen	karahta/minen
motocross-rataa	moto/cross/-/rata/a
liikenneväylien	liikenne/väyl/i/en
kaakkois-bosniaa	kaakkois/-/bosnia/a
lakkautusuhkaa	lakkaut/us/uhka/a
myrkkyonnettomuuksiin	myrkky/onne/ttom/uuks/i/in
kiekkojuniori	kiekko/juniori
marihuanalaatujen	marihuana/laatu/j/en
kehnoimmin	kehno/imm/i/n
ajojen	ajo/j/en
alamäkivauhtiaan	ala/mäki/vauhti/a/an
arvomerkkinsä	arvo/merkki/nsä
keksintöarsenaaliin	keksintö/arsenaali/in
täydennysruuaksi	täydenn/ys/ruua/ksi
galluppien	gallup/pie/n
rahankäyttöönsä	raha/n/käyttö/ö/nsä
laulunsanoja	laulu/n/sano/j/a
huippuravureita	huippu/ravure/i/ta
sadeojat	sade/oja/t
mittarihan	mittari/han
vakoniemi	vako/niemi
elämänkertoja	elä/mä/n/kerto/j/a
lukiolaisen	lukiolaise/n
pureeko	pure/e/ko
tulevallakaan	tule/va/lla/kaan
kitkeränsävyisesti	kitkerä/n/sävyise/sti
valitusosoituksen	valit/us/osoit/ukse/n
meriupseerien	meri/upseer/i/en
jalkapallokartalla	jalka/pallo/karta/lla
painuneita	painu/ne/i/ta
komentorakenteesta	komento/rakentee/sta
virtaava	virtaa/va
otettavalle	ote/tta/va/lle
vinouttavasti	vinoutta/va/sti
helmassa	helma/ssa
todentuntuisena	tode/n/tuntuise/na
julkisuusongelmista	julkis/uus/ongelm/i/sta
eksotiikkaakin	eksotiikka/a/kin
koreammin	korea/mm/i/n
kiedottiin	kiedo/tt/i/in
adoptioilta	adoptio/i/lta
linssille	linssi/lle
yhteisostojen	yhteis/osto/j/en
suomalaismenestykseen	suomalais/menestykse/en
tuovana	tuo/va/na
käsityöllisin	käsi/työ/llis/i/n
pienennettiin	piene/nne/tt/i/in
lehtikeli	lehti/keli
häpeilemättömyys	häpe/ile/mättöm/yys
ympäripäissään	ympäripä/i/ssä/än
kummasteli	kummastel/i
luulevan	luule/va/n
maestrolle	maestro/lle
työlupakäytäntö	työ/lupa/käytäntö
tiedottavansa	tiedotta/va/nsa
työkaluohjelmistojen	työ/kalu/ohjelmisto/j/en
tilapäiskekkerien	tila/päis/kekker/i/en
kevolta	kevo/lta
hienostuneeksi	hienostu/nee/ksi
jäseneltään	jäsene/ltä/än
kiemurtavaa	kiemurta/va/a
formulamaailmassa	formula/maa/ilma/ssa
minimivaatimusten	minimi/vaatimus/t/en
afaatikoilla	afaatiko/i/lla
ristiinnaulitsemalla	ristiinnaulitse/ma/lla
umpikaivolietteiden	umpi/kaivo/liette/i/den
alamaisiksi	ala/mais/i/ksi
huntua	huntu/a
olki	olki
kassakaapit	kassa/kaapi/t
kumoutuu	kumoutu/u
sanomalehtitalon	sano/ma/lehti/talo/n
lehterin	lehteri/n
allergisuus	allergis/uus
folk	folk
hakemuksesi	hakemukse/si
multimediaesitys	multi/media/esit/ys
lopputuloksissa	loppu/tuloks/i/ssa
paljastatte	paljasta/tte
etäopettaja	etäopetta/ja
ei-toivottavaan	ei/-/toivo/tta/va/an
alusvaate	alus/vaate
tasokkuus	tasokk/uus
koulukiusatuksi	koulu/kiusa/tu/ksi
huolisi	huol/isi
katetuotto	kate/tuotto
myrkyttömien	myrky/ttöm/i/en
käsitettiin	käsite/tt/i/in
haydnista	haydni/sta
kivi-kuvan	kivi/-/kuva/n
pilkankohde	pilka/n/kohde
iltajuhlasta	ilta/juhla/sta
metateoria	meta/teoria
pärjänneitä	pärjän/ne/i/tä
peltisissä	peltis/i/ssä
hävitä	hävi/tä
perheneuvonnassa	perhe/neuvonna/ssa
informaatioähkyn	informaatio/ähky/n
söderholmin	söderholmi/n
saastumisongelmat	saastu/mis/ongelma/t
hidastusmutkaa	hidast/us/mutka/a
viettää	viettä/ä
työttömiin	työ/ttöm/i/in
räjäytettävä	räjäyte/ttä/vä
kirja-arvostelijana	kirja/-/arvosteli/ja/na
avaamasta	avaa/ma/sta
yhteysupseerin	yhteys/upseeri/n
toistumassa	toistu/ma/ssa
ilvespeluri	ilves/peluri
ruokapakettien	ruoka/pakett/i/en
hallinnonaloja	hallinno/n/alo/j/a
nuortennäytelmiin	nuor/t/en/näytelm/i/in
turvallisuusneuvostoon	turva/llis/uus/neuvosto/on
beetakaroteenilla	beeta/karoteeni/lla
tielaki	tie/laki
lukemalta	luke/ma/lta
houkuttimiin	houkuttim/i/in
velkoa	velko/a
työllisyyskehityksen	työ/llis/yys/kehit/ykse/n
quijoteksi	quijote/ksi
roju	roju
tamilitiikereistä	tamili/tiikere/i/stä
rahastuslaite	rahast/us/laite
siistimmäksi	siisti/mmä/ksi
lyhtypylväissä	lyhty/pylvä/i/ssä
vapaaehtoisesti	vapa/a/ehtoise/sti
murentua	murentu/a
inkarnaatio	inkarnaatio
valmistuspalveluyritys	valmist/us/palvel/u/yrit/ys
saastuttamassa	saastu/tta/ma/ssa
lauluhetket	laulu/hetke/t
ostamat	osta/ma/t
nimiroolin	nimi/rooli/n
epiteetti	epiteetti
kalanviljelylaitoksissa	kala/n/viljel/y/laitoks/i/ssa
leniniläinen	lenini/läinen
hämeenlinnalaismiehen	hämeenlinnalais/miehe/n
sokeroi	sokeroi
budjettiriihistä	budjetti/riih/i/stä
suhteutetulla	suhteute/tu/lla
vaasankadun	vaasa/n/kadu/n
terveyspäivän	terve/ys/päivä/n
rankkareilla	rankkare/i/lla
kokousasioista	kokous/asio/i/sta
palatsiaukio	palatsi/aukio
ääniharavoina	ääni/hara/vo/i/na
löytäneensä	löytä/nee/nsä
studioitaan	studio/i/ta/an
huudollaan	huudo/lla/an
ilmapuolustusliiton	ilma/puolust/us/liito/n
ravintolasi	ravinto/lasi
ilves-kissoille	ilves/-/kisso/i/lle
varustettu	varuste/ttu
toivottamalta	toivo/tta/ma/lta
kotioloista	koti/olo/i/sta
peräseinälle	perä/seinä/lle
ulkomaiset	ulko/maise/t
kirjailee	kirjaile/e
foodissa	foodi/ssa
rakennetyöttömyys	rakenne/työ/ttöm/yys
hylsyihin	hylsy/i/hin
kilpa-ajajan	kilpa/-/aja/ja/n
kultamitali	kulta/mitali
jouluruoat	joulu/ruoa/t
opiskelijavaihtona	opiskeli/ja/vaihto/na
tuontitavaroille	tuonti/tavaro/i/lle
viriä	viri/ä
asianosaisena	asia/n/osaise/na
postinjakoalueittain	posti/n/jako/alue/ittain
komeasarvisia	komea/sarvis/i/a
yksityisautoja	yksityis/auto/j/a